produced	create or manufacture a man-made product
intensified	increase in extent or intensity
received	get something; come into possession of
sovereign	a nation's ruler or head of state usually by hereditary right
installment	a part of a broadcast serial
obligated	force somebody to do something
published	put into print
carcass	the dead body of an animal especially one slaughtered and dressed for food
satellite	any celestial body orbiting around a planet or star
ancient	belonging to times long past especially of the historical period before the fall of the Western Roman Empire
practice	knowledge of how something is usually done
edited	prepare for publication or presentation by correcting, revising, or adapting
invaded	march aggressively into another's territory by military force for the purposes of conquest and occupation
antagonist	someone who offers opposition
combat	battle or contend against in or as if in a battle
predomintantly	much greater in number or influence
retired	go into retirement; stop performing one's work or withdraw from one's position
founded	set up or found
longevity	the property of being long-lived
settled	establish or develop as a residence
produced	create or manufacture a man-made product
competition	an occasion on which a winner is selected from among two or more contestants
footballer	an athlete who plays American football
conceals	prevent from being seen or discovered
express	articulate; either verbally or with a cry, shout, or noise