discovered	make a discovery, make a new finding
various	having great diversity or variety
grasp	an intellectual hold or understanding
repealed	cancel officially
brawls	to quarrel noisily, angrily or disruptively
institution	an organization founded and united for a specific purpose
manuscript	the form of a literary work submitted for publication
relaid	*
persist	continue to exist
reclaim	claim back
portion	something determined in relation to something that includes it
awarded	give, especially as an honor or reward
allocated	distribute according to a plan or set apart for a special purpose
established	set up or found
sought	try to get or reach
scant	limit in quality or quantity
assembled	create by putting components or members together
characteristics	a prominent attribute or aspect of something
eliminated	remove from a contest or race
prohibited	command against
employees	a worker who is hired to perform a job
dispersing	move away from each other
atrocious	exceptionally bad or displeasing
relocated	move or establish in a new location
applied	put into service; make work or employ for a particular purpose or for its inherent or natural purpose
radiating	extend or spread outward from a center or focus or inward towards a center
estimated	judge tentatively or form an estimate of (quantities or time)
frustrated	*
bolster	support and strengthen
categories	a collection of things sharing a common attribute
concepts	an abstract or general idea inferred or derived from specific instances
deadlocked	at a complete standstill because of opposition of two unrelenting forces or factions
eminent	standing above others in quality or position
headlining	*
novels	an extended fictional work in prose; usually in the form of a story
attempted	make an effort or attempt
origin	the place where something begins, where it springs into being
unstable	lacking stability or fixity or firmness
commemorate	be or provide a memorial to a person or an event
terminated	be the end of; be the last or concluding part of
vessels	a craft designed for water transportation
degenerative	(of illness) marked by gradual deterioration of organs and cells along with loss of function
denote	have as a meaning
offense	a transgression that constitutes a violation of what is judged to be right
treacherous	dangerously unstable and unpredictable
merging	become one
aired	be broadcast
vitality	a healthy capacity for vigorous activity
retain	allow to remain in a place or position or maintain a property or feature
dissipated	*
meander	a bend or curve, as in a stream or river
influx	the process of flowing in
demolished	destroy completely
recipient	a person who receives something
retrieving	*
components	*
shifted	make a shift in or exchange of
corporation	a business firm whose articles of incorporation have been approved in some state
introducing	bring in or establish in a new place or environment
exhibit	show an attribute, property, knowledge, or skill
flee	run away quickly
circuits	a racetrack for automobile races
incorporate	*
maintained	cause to continue in a certain state, position, or activity; e.g., `keep clean'
hypotheses	a tentative insight into the natural world; a concept that is not yet verified but that if true would explain certain facts or phenomena
facilitating	make easier
garment	an article of clothing
genuine	not pretended; sincerely felt or expressed
precepts	rule of personal conduct
establishment	*
roaming	move about aimlessly or without any destination, often in search of food or employment
addresses	act on verbally or in some form of artistic expression
resides	make one's home in a particular place or community
utilize	put into service; make work or employ for a particular purpose or for its inherent or natural purpose
purchase	obtain by purchase; acquire by means of a financial transaction
enhanced	increased or intensified in value or beauty or quality
elongated	having notably more length than width; being long and slender
incorporated	unite or merge with something already in existence
venues	the scene of any event or action (especially the place of a meeting)
deployed	*
relocated	move or establish in a new location
odor	any property detected by the olfactory system
devastated	cause extensive destruction or ruin utterly
replicate	reproduce or make an exact copy of
incepted	*
commandeer	take arbitrarily or by force
suspended	make inoperative or stop
safeguard	make safe
apportion	distribute according to a plan or set apart for a special purpose
rotund	excessively fat
depiction	*
startle	*
emerged	become known or apparent
dismissed	terminate the employment of; discharge from an office or position
manufactures	put together out of artificial or natural components or parts
associated	*
inaugural	serving to set in motion
prestigious	having an illustrious reputation; respected
sought	make an effort or attempt
extruded	form or shape by forcing through an opening