role	*
noted	make mention of
inhabitants	a person who inhabits a particular place
abolished	do away with
appointed	assign a duty, responsibility or obligation to
subsequently	happening at a time subsequent to a reference time
convince	make (someone) agree, understand, or realize the truth or validity of something
divert	*
designation	identifying word or words by which someone or something is called and classified or distinguished from others
traversed	travel across or pass over
garment	an article of clothing
object	the goal intended to be attained (and which is believed to be attainable)
principles	a basic generalization that is accepted as true and that can be used as a basis for reasoning or conduct
occasionally	sporadically and infrequently
emblazoned	*
integral	*
disciplines	a branch of knowledge
inhabitants	a person who inhabits a particular place
diagram	a drawing intended to explain how something works; a drawing showing the relation between the parts
issued	circulate or distribute or equip with